11111111
11100111
11100111
11100111
11100111
11100111
11133111
11144111
