11111111
10103021
10101011
10101301
10101004
10131011
10001021
11111111
