11111111
10000001
11111131
10000001
13111111
10000001
10020004
11111111
