11111111
10033001
10020001
10011201
10211001
10002001
10000004
11111111
