11111111
10000001
10000001
11100001
11100004
11100001
11130201
11111111
