11111111
12121211
13030301
10000001
10000001
13030304
12121211
11111111
