11111111
10000001
10133101
10122101
10133104
10000001
12111121
11111111
