11111111
10000011
10111101
10122101
10133101
10100101
10000001
11111141
