11111111
10000001
10100101
10000001
10100101
10303031
10111104
11111111
