11111111
10000001
10000001
11100001
11100001
11100001
11100201
11111111